magnirostris.Genovesa.11_A	G.magnirostris
magnirostris.Genovesa.2_A	G.magnirostris
magnirostris.Genovesa.3_A	G.magnirostris
magnirostris.Genovesa.4_A	G.magnirostris
magnirostris.Genovesa.7_A	G.magnirostris
magnirostris.Daphne.9287_A	G.magnirostris
magnirostris.Daphne.9309_A	G.magnirostris
magnirostris.Daphne.9379_A	G.magnirostris
magnirostris.Daphne.9387_A	G.magnirostris
magnirostris.Daphne.9398_A	G.magnirostris
magnirostris.Daphne.9703_A	G.magnirostris
magnirostris.Daphne.9709_A	G.magnirostris
magnirostris.Daphne.9737_A	G.magnirostris
magnirostris.Daphne.9773_A	G.magnirostris
magnirostris.Daphne.9779_A	G.magnirostris
fuliginosa.SantaCruz.12_A	G.fuliginosa
fuliginosa.SantaCruz.15_A	G.fuliginosa
fuliginosa.Daphne.10317_A	G.fuliginosa
fuliginosa.Daphne.15673_A	G.fuliginosa
fuliginosa.Espanola.1_A	G.fuliginosa
fuliginosa.Espanola.3_A	G.fuliginosa
fuliginosa.Espanola.4_A	G.fuliginosa
fuliginosa.Santiago.1_A	G.fuliginosa
fuliginosa.Santiago.12_A	G.fuliginosa
fuliginosa.Santiago.13_A	G.fuliginosa
fuliginosa.Santiago.16_A	G.fuliginosa
fuliginosa.Santiago.19_A	G.fuliginosa
fuliginosa.Santiago.2_A	G.fuliginosa
fuliginosa.Santiago.22_A	G.fuliginosa
fuliginosa.Santiago.23_A	G.fuliginosa
fuliginosa.Santiago.3_A	G.fuliginosa
fuliginosa.Santiago.8_A	G.fuliginosa
fuliginosa.Daphne.19165_A	G.fuliginosa
fuliginosa.Daphne.19168_A	G.fuliginosa
parvulus.SantaCruz.1a_A	C.parvulus
parvulus.SantaCruz.2a_A	C.parvulus
parvulus.Fernandina.104_A	C.parvulus
parvulus.Fernandina.106_A	C.parvulus
parvulus.Fernandina.107_A	C.parvulus
parvulus.Fernandina.109_A	C.parvulus
parvulus.Floreana.2_A	C.parvulus
parvulus.Floreana.3_A	C.parvulus
parvulus.Floreana.4_A	C.parvulus
parvulus.Isabela.1_A	C.parvulus
parvulus.Isabela.4_A	C.parvulus
parvulus.Isabela.5_A	C.parvulus
parvulus.SantaFe.1_A	C.parvulus
parvulus.SantaFe.2_A	C.parvulus
parvulus.SantaFe.3_A	C.parvulus
parvulus.SantaCruz.1_A	C.parvulus
parvulus.SantaCruz.13_A	C.parvulus
parvulus.SantaCruz.17_A	C.parvulus
parvulus.SantaCruz.18_A	C.parvulus
parvulus.SantaCruz.2_A	C.parvulus
parvulus.SantaCruz.4_A	C.parvulus
parvulus.SantaCruz.5_A	C.parvulus
parvulus.SantaCruz.6_A	C.parvulus
parvulus.SantaCruz.7_A	C.parvulus
parvulus.SantaCruz.8_A	C.parvulus
inornata.Cocos.1_A	P.inornata
inornata.Cocos.2_A	P.inornata
inornata.Cocos.3_A	P.inornata
inornata.Cocos.4_A	P.inornata
inornata.Cocos.5_A	P.inornata
inornata.Cocos.6_A	P.inornata
inornata.Cocos.7_A	P.inornata
inornata.Cocos.8_A	P.inornata
magnirostris.Genovesa.11_B	G.magnirostris
magnirostris.Genovesa.2_B	G.magnirostris
magnirostris.Genovesa.3_B	G.magnirostris
magnirostris.Genovesa.4_B	G.magnirostris
magnirostris.Genovesa.7_B	G.magnirostris
magnirostris.Daphne.9287_B	G.magnirostris
magnirostris.Daphne.9309_B	G.magnirostris
magnirostris.Daphne.9379_B	G.magnirostris
magnirostris.Daphne.9387_B	G.magnirostris
magnirostris.Daphne.9398_B	G.magnirostris
magnirostris.Daphne.9703_B	G.magnirostris
magnirostris.Daphne.9709_B	G.magnirostris
magnirostris.Daphne.9737_B	G.magnirostris
magnirostris.Daphne.9773_B	G.magnirostris
magnirostris.Daphne.9779_B	G.magnirostris
fuliginosa.SantaCruz.12_B	G.fuliginosa
fuliginosa.SantaCruz.15_B	G.fuliginosa
fuliginosa.Daphne.10317_B	G.fuliginosa
fuliginosa.Daphne.15673_B	G.fuliginosa
fuliginosa.Espanola.1_B	G.fuliginosa
fuliginosa.Espanola.3_B	G.fuliginosa
fuliginosa.Espanola.4_B	G.fuliginosa
fuliginosa.Santiago.1_B	G.fuliginosa
fuliginosa.Santiago.12_B	G.fuliginosa
fuliginosa.Santiago.13_B	G.fuliginosa
fuliginosa.Santiago.16_B	G.fuliginosa
fuliginosa.Santiago.19_B	G.fuliginosa
fuliginosa.Santiago.2_B	G.fuliginosa
fuliginosa.Santiago.22_B	G.fuliginosa
fuliginosa.Santiago.23_B	G.fuliginosa
fuliginosa.Santiago.3_B	G.fuliginosa
fuliginosa.Santiago.8_B	G.fuliginosa
fuliginosa.Daphne.19165_B	G.fuliginosa
fuliginosa.Daphne.19168_B	G.fuliginosa
parvulus.SantaCruz.1a_B	C.parvulus
parvulus.SantaCruz.2a_B	C.parvulus
parvulus.Fernandina.104_B	C.parvulus
parvulus.Fernandina.106_B	C.parvulus
parvulus.Fernandina.107_B	C.parvulus
parvulus.Fernandina.109_B	C.parvulus
parvulus.Floreana.2_B	C.parvulus
parvulus.Floreana.3_B	C.parvulus
parvulus.Floreana.4_B	C.parvulus
parvulus.Isabela.1_B	C.parvulus
parvulus.Isabela.4_B	C.parvulus
parvulus.Isabela.5_B	C.parvulus
parvulus.SantaFe.1_B	C.parvulus
parvulus.SantaFe.2_B	C.parvulus
parvulus.SantaFe.3_B	C.parvulus
parvulus.SantaCruz.1_B	C.parvulus
parvulus.SantaCruz.13_B	C.parvulus
parvulus.SantaCruz.17_B	C.parvulus
parvulus.SantaCruz.18_B	C.parvulus
parvulus.SantaCruz.2_B	C.parvulus
parvulus.SantaCruz.4_B	C.parvulus
parvulus.SantaCruz.5_B	C.parvulus
parvulus.SantaCruz.6_B	C.parvulus
parvulus.SantaCruz.7_B	C.parvulus
parvulus.SantaCruz.8_B	C.parvulus
inornata.Cocos.1_B	P.inornata
inornata.Cocos.2_B	P.inornata
inornata.Cocos.3_B	P.inornata
inornata.Cocos.4_B	P.inornata
inornata.Cocos.5_B	P.inornata
inornata.Cocos.6_B	P.inornata
inornata.Cocos.7_B	P.inornata
inornata.Cocos.8_B	P.inornata
